...............................................................................................................................................
...............................................................................................................................................
...............................................................................................................................................
...............................................................................................................................................
...............................................................................................................................................
...............................................................................................................................................
...............................................................................................................................................
...............................................................................................................................................
...............................................................................................................................................
...............................................................................................................................................
...............................................................................................................................................
...............................................................................................................................................
...............................................................................................................................................
...............................................................................................................................................
...............................................................................................................................................
.........................###...............................................................................###.................................
.........................#####################################################################################.................................
.........................###...............................................................................###.................................
..........................#.................................................................................#..................................
..........................#.................................................................................#..................................
..........................#.................................................................................#..................................
..........................#....#########################################################################....#..................................
..........................#....#....##.....##....#.....#...............................................#....#..................................
..........................#....##....##....##....#....##...............................................#....#..................................
..........................#....##....##....##....#....##...............................................#....#..................................
..........................#....##....##....#.....#....##...............................................#....#..................................
..........................#....#.....#.....#.....#.....#...........#####....#####....###.#####.#####.###....#..................................
..........................#....###.#####.#####.#####.###...........#............#....##....#.....#.....#....#..................................
..........................#....#...................................#............#....##....##....#.....#....#..................................
..........................#....#...................................#............#....##....##....#..#..#....#..................................
..........................#....#...................................#............#....#.....##....##....#....#..................................
..........................#....#...................................#............#....#.....#.....##....#....#..................................
..........................#....##....###############...............#............#....###################....#..................................
..........................#....#...........#..##...#...............#............#....##....#.....#....##....#..................................
..........................#....#...........#.......#...............#............#....##....#....##....##....#..................................
..........................#....#..##.......#.......#...............#............#....##....#....##....##....#..................................
..........................#....#..##.......#...##..#...............#............#....#.....#....##.....#....#..................................
..........................#....#......##...#...##..#...............#............#....#.....#.....#.....#....#..................................
..........................#....#......##...#...##..#...............#####....#####....###.#####.#####.###....#..................................
..........................#....#...........#...##..#...................................................#....#..................................
..........................#....#..##.......#.......#...................................................#....#..................................
..........................#....#..##.......#.......#...................................................#....#..................................
..........................#....#...........#.......#...................................................#....#..................................
..........................#....#######....##########....###.#####.#####.#####.###############....#######....#..................................
..........................#....#........................#.....#.....#.....#.....#.###########....#####.#....#..................................
..........................#....#........................#.....#.....#.....##....#.###########....#.....#....#..................................
..........................#....#........................#....##....##....###....#.#.........#....#.....#....#..................................
..........................#....#........................#....##....##....###....#.#.........#....#.....#....#..................................
..........................#....#####################....#....##....##....##.....#.#.........#..........#....#..................................
..........................#....#..#.#.#.#.#.#.#.#..#....#########################.#.........#.......##.#....#..................................
..........................#....#..#.#.#.#.#.#.#.#..#....##....##....#.....#.....#.#.........#....#..##.#....#..................................
..........................#....#...................#....##....##....##....#....##.#..............#.....#....#..................................
..........................#....#...................#....##....##....##....#....##.#..............#.....#....#..................................
..........................#....#..###############.......#.....#.....##....#....##.#.........#....#######....#..................................
..........................#....#..###############.......#.....#.....#.....#.....#.#.........#....#..........#..................................
..........................#....#...................#....###.#####.#####.#####.###############....#..........#..................................
..........................#....#...................#.............................................#..........#..................................
..........................#....#..#.#.#.#.#.#.#.#..#.............................................#..........#..................................
..........................#....#..#.#.#.#.#.#.#.#..#.............................................#..........#..................................
..........................#....#####################.............................................#..........#..................................
..........................#.........#..............#....##########################################..........#..................................
..........................#.........#..............#....#...................................................#..................................
..........................#.........#..............#....#...................................................#..................................
..........................#.........#..............#....#...................................................#..................................
..........................#.........################....#...................................................#..................................
..........................#.........#...................#...................................................#..................................
..........................#.........#...................#...................................................#..................................
..........................#.........#.............#.....#...................................................#..................................
..........................#.........#...................#...................................................#..................................
..........................#.........#....################...................................................#..................................
..........................#.........#....#..................................................................#..................................
..........................#.........#....#..................................................................#..................................
..........................#.........######..................................................................#..................................
..........................#.................................................................................#..................................
..........................#.................................................................................#..................................
..........................#.................................................................................#..................................
.........................###...............................................................................###.................................
.........................#####################################################################################.................................
.........................###...............................................................................###.................................
...............................................................................................................................................
...............................................................................................................................................
...............................................................................................................................................
...............................................................................................................................................
...............................................................................................................................................
...............................................................................................................................................
...............................................................................................................................................
...............................................................................................................................................
...............................................................................................................................................
...............................................................................................................................................
...............................................................................................................................................
...............................................................................................................................................
...............................................................................................................................................
...............................................................................................................................................
...............................................................................................................................................
...............................................................................................................................................
...............................................................................................................................................
...............................................................................................................................................
...............................................................................................................................................